a	a
b	b
bh	b̤
ch	tʃ
d	d
dh	d̤
dy	dʲ ɡ
dzv	d β z
e	e
f	f
g	ɡ
h	h
i	i
j	dʒ
k	k
l	l
m	m
mh	m̤
n	n
ng	ŋ
o	o
p	p
r	rʷ
s	s
sv	ɸ s
sw	s kʷʱ
t	t
tsv	t ɸ s
ty	tʲ k
u	u
v	β
vh	v
w	w
y	j
z	z
zv	β z

