
م	m
ن	n
د	d
ت	t
ب	b
پ	p
ف	f
ق	q
ك	k
ڭ	ŋ
گ	ɡ
غ	ʁ
ھ	h
خ	χ
چ	tʃ
ج	dʒ
ژ	ʒ
ز	z
س	s
ش	ʃ
ر	r
ل	l
ئا	ɑ
ئە	ɛ
ئې	e
ئى	i
ئۆ	ø
ئو	o
ئۇ	u
ئۈ	y
ا	ɑ
ە	ɛ
ې	e
ى	i
ۆ	ø
و	o
ۇ	u
ۈ	y
ي	j
ۋ	w
