a	a
añ	ã
b	b
c	ʃ
ç	ɽ
d	d̪
e	e
eñ	ẽ
f	f
g	g
h	x
i	i
iñ	ĩ
j	ɟ
k	k
l	l
m	m
n	n
o	ɔ
oñ	ɔ̃
p	p
q	q
r	ɾ
s	s
t	t̪
u	u
uñ	ũ
v	v
w	w
x	k s
y	j
z	z
ch	c
dh	ɖ
h’	h
kh	x
ng	ŋ
ny	ɲ
ou	o
ouñ	õ
oou	oː
oouñ	õː
th	t̪
ts	t̪	

