a	a
b	b
ç	tʃ
d	d
e	e
ä	æ
f	ɸ
g	ɡ
h	h
i	i
j	dʒ
ž	ʒ
k	k
l	l
m	m
n	n
ň	ŋ
o	o
ö	ø
p	p
r	r
s	θ
ş	ʃ
t	t
u	u
ü	y
w	β
y	ɯ
ý	j
z	ð

