а	a
б	b
ч	tʃ
д	d
е	je
е	e
ә	æ
ф	ɸ
г	ɡ
х	h
и	i
җ	dʒ
ж	ʒ
к	k
л	l
м	m
н	n
ң	ŋ
о	o
ө	ø
п	p
р	r
с	θ
с	s
ш	ʃ
т	t
у	u
ү	y
в	β
ы	ɯ
й	j
з	ð
з	z
