
a	a
á	a˦
c	ts
ci	tʃ i
d	d
e	e
é	e˦
é	e˦
g	ɡ
h	h
i	i
í	i˦
í	i˦
ī	i˦
k	k
l	l
m	m
n	n
o	o
ó	o˦
p	p
r	ɾ
s	s
si	ʃ i
š	ʃ
t	t
ti	tʃ i
u	u
ú	u˦
v	v
w	ʊ
y	ɪ 
=	#
・	#
́	˦
