А 	a 
а	a
Б 	b 
б	b
В 	ʋ 
в	ʋ
Г 	ɡ 
г	ɡ
Д 	d
д	d
Ђ 	dʑ 
ђ	dʑ
Е 	e 
е	e
Ж 	ʒ 
ж	ʒ
З 	z 
з	z
И 	i 
и	i
Ј 	j 
ј	j
К 	k 
к	k
Л 	l 
л	l
Љ 	ʎ 
љ	ʎ
М 	m 
м	m
Н 	n 
н	n
Њ 	ɲ 
њ	ɲ
О 	o 
о	o
П 	p 
п	p
Р 	r 
р	r
С 	s 
с	s
Т 	t 
т	t
Ћ 	tɕ 
ћ	tɕ
У 	u 
у	u
Ф 	f 
ф	f
Х 	x 
х	x
Ц 	ts 
ц	ts
Ч 	tʃ 
ч	tʃ
Џ 	dʒ 
џ	dʒ
Ш 	ʃ 
ш	ʃ

