a 	ɐ 
aa 	ɑː 
b	b
c 	tʃʼ
ch 	tʃ
d	d
dh 	ᶑ	
e	ɛ
ee	eː
f	f
g 	ɡ
h	h
i	ɪ
ii	iː
j 	dʒ
k	k
l	l
m	m
n	n
ny 	ɲ	
o 	ɔ
oo 	oː 
p	p
ph 	pʼ
q 	kʼ
r	r
s	s
sh 	ʃ
t	t
th	tʼ
u 	ʊ
uu	uː
v	v
w	w
x 	tʼ
y 	j
z	z	
' 	ʔ


