i 	i
ii	iː
u	u
uu	uː
é 	e	
éé 	eː
ó 	o	
óó 	oː
ë 	ə			
e	ɛ
ee	ɛː
o	ɔ
oo	ɔː
a	a	
à 	aː
aa	aː
m	m
n	n
ñ 	ɲ
ŋ 	ŋ
mb	mb
nd	nd
nj	ɲɟ
ng	ŋɡ
b	b
d	d
j	ɟ
g	ɡ
p	p
t	t
c	c
k	k
q	qː
‘	ʔ
f	f
s	s
x	x
r	r
w	w
y	j
l	l
bb	bː
dd	dː
jj	ɟː
gg	ɡː
pp	pː
tt	tː
cc	cː
kk	kː
rr	rː
ww	wː
yy	jː
ll	lː

