a	a
á	a
ã	ã
ch	ɕ
e	ɛ
é	ɛ
ẽ	ẽ
g 	ɰ
g̃	ɰ̃
gu	w
g̃u	w̃
h	x
h	h
i	i
í	i
ĩ	ĩ
j	dʒ
k	k
ku	kʷ
l	l
ll	j
m	m
mb	mb
n	n
nd	nd
ng	ŋ
ng	ŋɡ
ngu	ŋʷ 
ngu	ŋɡʷ
nt	nt
ñ 	ɲ
o	ɔ
õ	õ
ó	ɔ
p	p
r 	ɾ
r	ɾ̃
rr	r
s	s
t	t
u	u
ú	u
ũ	ũ
v	ʋ
y	ɨ
ý	ɨ
ỹ	ɨ
’	ʔ
'	ʔ
