ㄱ	k
ㄴ	n
ㄷ	t
ㄹ	l
ㅁ	l
ㅂ	p
ㅅ	s
ㅇ eps
ㅇ ŋ
ㅈ	t̠ʃ
ㅊ	t̠ʃʰ
ㅋ	kʰ
ㅌ	tʰ
ㅍ	pʰ
ㅎ	h
ㄲ	kˀ
ㄸ	tˀ
ㅃ	pˀ
ㅆ	sˀ
ㅉ	t̠ʃˀ
ㄳ gs
ㄵ	n t̠ʃ
ㄶ	n h
ㄺ	l k
ㄻ	l m
ㄼl p
ㄽ	l s
ㄾ	l tʰ
ㄿ	l pʰ
ㅀ	l h
ㅄ	p s
ㅏ	a
ㅓ	ɤ
ㅗ	o
ㅜ	u
ㅡ	ɯ
ㅣ	i
ㅐ	æ
ㅔ	e
ㅑ	j a
ㅕ	j ɤ
ㅛ 	j o
ㅠ	j u
ㅒ	j æ
ㅖ	j e
ㅘ	w a
ㅙ	w æ
ㅝ	w o
ㅞ	w e
ㅚ	ø
ㅟ	y
ㅢ	ɯ i

