а	a
б	p
в	w
г	ɡ
д	t
е	ji
ё	jɔ
ж	tʃ
з	ts
и	i
й	i
к	kʰ
л	ɮ
м	m
н	n
о	ɔ
ө	ɵ
є 	ɵ
п	pʰ
р	r
с	s
т	tʰ
у	ʊ
ү	u
ї	u
ф	f
х	x
ц	tsʰ
ч	tʃʰ
ш	ʃ
щ	ʃtʃ
ъ	eps
ы	i
ь	j
э	e
ю	jʊ
я	ja
