a 	ɑ 
a	aː 
aa 	aː
ä 	æ 
e 	æ
e	ə 
ë 	ə
é 	e
ee	eː
i 	i 
i	iː 
ii 	iː
o 	o 
o	oː 
oo	oː
u 	u 
u	uː 
uu 	uː
ai 	ɑɪ̯ 
ei 	ɑɪ̯
äi 	æːɪ̯ 
au	ɑʊ 
au	æːʊ̯ 
éi 	əɪ 
ie 	iə 
ou 	əʊ 
ue 	uə
ar	aː
aar	aː
är 	ɛːə 
äer 	ɛːə
er 	ɐ
ir 	iːə 
ier 	iːə
or 	oːə 
oer 	oːə
ur 	uːə 
uer 	uːə
b	b
c	ts
ch	χ
d	d
f	f
g	ɡ
h	h
j	j
k	k
l	l
m	m
n	n
ng	ŋ
p	p
ph	f
qu	kv
r	ʁ
s	s
sp	ʃp
st	ʃt
sch	ʃ
t	t
v	v
w	v
z	z

