b	b
ch	ʃ
d	d
f	f
g	ɡ
h	h
j	ʒ
k	k
l	l
m	m
n	n
ng	ŋ
p	p
r	ɣ
s	s
t	t
v	v
z	z
dj	dʒ
w	w
y	j
u	ɥ
a	a
à	a
e	e
è	ɛ
i	i
o	o
ò	ɔ
ou	u
an	ã
en	ɛ̃
on	ɔ̃
oun	ũ
x	k s
