a	a
b 	b
c	ɟ
ch 	tʃ
d 	d
e	e
f 	f	
g 	g	
h 	h
i	i
j 	ʒ
k 	k	
l 	l
m	m
n 	n
n	ɲ
ng 	ŋ	
o	o
p 	p
q	k
ry 	r
r	ɾ
s 	s
sh 	ʃ	
t 	t
u	u
v 	v
w 	w
z 	z
y 	j	
z	z
á	a˥
é	e˥
í	i˥
ó	o˥
ú	u˥
â	a˥
ê	e˥
î	i˥
ô	o˥
û	u˥
ā	aa˩
ē	ee˩
ī	ii˩
ō	oo˩
ū	uu˩
ǎ	aa˥
ě	ee˥
ǐ	ii˥
ǒ	oo˥
ǔ	uu˥
ä	aa˥
ë	ee˥
ï	ii˥
ö	oo˥
ü	uu˥

