a	a
b 	b
c	ɟ
ch 	tʃ
d 	d
e	e
f 	f	
g 	g	
h 	h
i	i
j 	ʒ
k 	k	
l 	l
m	m
n 	n
n	ɲ
ng 	ŋ	
o	o
p 	p
q	k
ry 	r
r	ɾ
s 	s
sh 	ʃ	
t 	t
u	u
v 	v
w 	w
z 	z
y 	j	
z	z
á	a˥
é	e˥
í	i˥
ó	o˥
ú	u˥
â	a˥
ê	e˥
î	i˥
ô	o˥
û	u˥
ā	aː˩
ē	eː˩
ī	iː˩
ō	oː˩
ū	uː˩
ǎ	aː˥
ě	eː˥
ǐ	iː˥
ǒ	oː˥
ǔ	uː˥
ä	aː˥
ë	eː˥
ï	iː˥
ö	oː˥
ü	uː˥

