a	a	
b	b
ch	tʃ
d	d
e	e	
f	f
g	ɡ
gb	ɓ
gb	ɡɓ
gh	ɣ
gw	ɡw
h	ɦ
i	i
ị	ɪ̙	
j	dʒ
k	k
kp	ɓ̥
kp	kp
kw	kw
l	l
m	m
n	n
nw	ŋw	
ny	ɲ	
Ñ	ŋ	
o	o
Ọ 	ɔ̙
ọ	ɔ̙
p	p	
r	ɹ
s	s
sh	ʃ
t	t
u	u
Ụ	ʊ̙
ụ	ʊ̙
 v	v
w	w
y	j
z	z
