a	a 
e	ə 
é	e 
è	ɛ 
ë	ə 
eu	ɯ 
i	i 
o	ɔ 
ô	o 
ö	ʌ 
u	u 
b	b 
c	c 
d	d 
f	f 
g	g 
h	h 
j	ɟ 
k	k
l	l 
m	m 
mb	mb 
n	n 
nd	nd 
ng	ŋ 
ngg	ŋg 
nj	ɲɟ 
ny	ɲ 
p	p 
q	q 
r	r 
s	s 
sy	ʃ 
t	t 
v	v 
w	w 
x	ks 
y	j 
z	z


