и 	i	
ы 	ə	
у 	u
е 	e	
ӕ 	æ	
о 	o
а 	a
б 	b
д 	d		
г 	ɡ	
гу 	ɡʷ		
п 	p	
т 	t		
к 	k	
ку 	kʷ	
хъ 	q	
хъу 	qʷ
пъ 	pʼ	
тъ 	tʼ		
къ 	kʼ	
къу 	kʼʷ
дз 	dz	
дж 	dʒ
ц 	ts	
ч 	tʃ
цъ 	tsʼ	
чъ 	tʃʼ
в 	v	
з 	z			
гъ 	ʁ	
ф 	f	
с 	s			
х 	χ	
ху 	χʷ
м 	m	
н 	n
л 	l
р 	r	
й 	j		
у 	w		

