i	i
u	u
e	e
o	o
a	a
c	ǀ
x	ǁ
q	ǃ
ch	ǀʰ
xh	ǁʰ
qh	ǃʰ
gc	ᶢǀʱ
gx	ᶢǁʱ
gq	ᶢǃʱ
nc	ᵑǀ
nx	ᵑǁ
nq	ᵑǃ
ngc	ᵑǀʱ
ngx	ᵑǁʱ
ngq	ᵑǃʱ
m	m
n	n
ny	ɲ
ng	ŋ
p	pʼ
t	tʼ
k	kʼ
ph	pʰ
th	tʰ
kh	kʰ
bh	b̤
d	d̤
g	ɡ̈
b	ɓ
k	ɠ
tsh	tʃʼ
kl	kxʼ
j	dʒ̈
f	f
s	s
hl	ɬ
sh	ʃ
h	h
v	v̤
z	z̤
dl	ɮ̈
hh	ɦ̤
l	l
y	j
w	w
