aa	ɑ
ae	æ
ah	ʌ
ao	ɔ
aw	aʊ
ay	aɪ
b	b
ch	tʃ
d	d
dh	ð
eh	ɛ
er	ɝ
ey	e
f	f
g	ɡ
hh	h
ih	ɪ
iy	i
jh	dʒ
k	k
l	l
m	m
n	n
ng	ŋ
ow	o
oy	ɔɪ
p	p
r	ɹ
s	s
sh	ʃ
t	t
th	θ
uh	ʊ
uw	u
v	v
w	w
y	j
z	z
zh	ʒ
