i	i 
í	i˥
ì	i˩
e	e
é	e˥
è	e˩
a	a
á	a˥
à	a˩
o	o
ó	o˥
ò	o˩
ô	o˥
u	u
ú	u˥
ù	u˩
m	m
n	n
ñ	ɲ
ŋ	ŋ
b	b
d	d
j	dj
p	p
t	t
c	tʃ
k	k
f	f
s	s
h	h
w	w
l	l
r	r
y	j
