a	a
á	aː	
ä	ɛ
e	ɛ	
é	ɛː	
i	i	
í	iː	
ia	i̯a
ie	i̯e
iu	i̯u
o	o	
ó	oː	
ô	u̯o	
u	u	
ú	uː	
y	i	
ý	iː	
b	b	
c	ts	
č	tʃ	
d	d	
ď	ɟ	
de	ɟ ɛ
di	ɟ i
dí	ɟ iː	
dia	ɟ ia	
die	ɟ ie	
dz	dz	
dž	dʒ	
f	f	
g	ɡ	
h	ɦ	
ch	x	
j	j	
k	k	
l	l
ĺ	l̩ː	
ľ	ʎ
lia	ʎ ia
lie	ʎ ie	
m	m	
n	n
ng	ŋ
nk	ŋ k
ň	ɲ	
ne	ɲ ɛ
ni	ɲ i
ní	ɲ iː
nia	ɲ ia
nie	ɲ ie
p	p	
q	k v
r	r
ŕ	r̩ː	
s	s	
š	ʃ	
t	t
ť	c	
ne	c ɛ
ni	c i
ní	c iː
nia	c ia
nie	c ie
v	v	
w	v
x	k s
z	z	
ž	ʒ	

