а	a
б	b
в	v
г	ɡ
ғ	ʁ
д	d
е	e
ё	jɔ
ж	ʒ
з	z
и	i
ӣ	ˈi
й	j
к	k
қ	q
л	l
м	m
н	n
о	ɔ
п	p
р	ɾ
с	s
т	t
у	u
ӯ	ɵ
ф	f
х	χ
ҳ	h
ч	tʃ
ҷ	dʒ
ш	ʃ
ъ	ʔ
э	e
ю	ju
я	ja
