а	a
ә	æ
б	b
в	w
г	ɡ
д	d
е	je
ё	jo
ж	ʒ
җ	ʑ
з	z
и	i
й	j
к	k
л	l
м	m
н	n
ң	ŋ
о	o
ө	ø
п	p
р	r
с	s
т	t
у	u
ү	y
ф	f
х	x
һ	h
ц	ts
ч	ɕ
ш	ʃ
щ	ʃ ɕ
ъ	ʔ
ы	ɤ
ь	ʔ
э	e
ю	ju
я	ja

