a	aː
â	ɔː	
e	eː	
ê	ɛː	
é	eː	
i	iː	
y	iː	
o	oː	
ô	ɔː	
u	yː	
û	uː	
ú	yː
b	b
c	ts
d	d	
f	f
g	ɣ
h	h
j	j
k	k
l	l
m	m
n	n
p	p
q	k
r	r
s	s
t	t
v	f
w	v
x	ks
z	tz	
ch	x
ng	ŋ
sj	sʲ
zj	zʲ
