a	a
a’	aː
b	b
d	d̪
e	e
f	ɸ
g	ɡ
h	h
h’	h
i	i
i’	iː
i	ɨ
i	ɨː
j	dʒ
k	k
l	l
m	m
n	n
o	ɒ
o’	ɒː
p	p
q	q
r	r
s	s
s’	s
t	t̪
u	u
u’	uː
u	ʉ
u’	ʉː
v	v
x	χ
y	j
z	z
oʻ	ɵ
gʻ	ʁ
sh	ʃ
ch	tʃ
ng	ŋ
ʼ	ʔ

