a	ɑ
b	b
b	w
v	v
g	ɡ
ğ	ʁ
d	d
e	e
c	dʒ
z	z
i	i
y	j
k	k
l	l
m	m
n	n
ñ	ŋ
o	o
ö	ø
p	p
r	r
s	s
t	t
u	u
ü	y
f	f
h	χ
ts	ts
ç	tʃ
ş	ʃ
ı	ɯ

