м 	m
н 	n
д 	d
т 	t
б 	b
п 	p
ф 	f
к 	k
қ 	q
ң 	ŋ
г 	ɡ
ғ 	ʁ
һ 	h
Һ	h
х 	χ
ч 	tʃ
җ 	dʒ
ж 	ʒ
з 	z
с 	s
ш 	ʃ
р 	r
л	l
а 	ɑ
ә 	ɛ
е 	e
и 	i
ө 	ø
о 	o
у 	u
ү 	y
й	j
в	w
ю	j u
я	j ɑ 

